R 480 360
NO ./textures/redbrick.png
SO ./textures/greystone.png
WE ./textures/colorstone.png
EA ./textures/bluestone.png

S ./textures/barrel.png
F 255,0,0
C 0,0,255

 11111111111111111111111111111111111
1000000000000000000000000000000000001
1000200000111111111111111110000000001
10E02000001               10000000001
10002000001               10000200001
1000000000111111111111111110000000001
1000020000000000000000000000000000001
 11111111111111111111111111111111111