R 480 360
NO ./textures/redbrick.png
SO ./textures/greystone.png
WE ./textures/colorstone.png
EA ./textures/bluestone.png

S ./textures/barrel.png
F 220,100,0
C 225,30,0

1111111
100000111111111
12N020202020001
100000111111111
1111111