R 480 360
NO ./textures/redbrick.png
SO ./textures/greystone.png
WE ./textures/colorstone.png
EA ./textures/bluestone.png

S ./textures/barrel.png
F 220,100,0
C 225,30,0

1111
1W21
1111