R 360 240
NO textures/brick.xpm   			
SO ./textures/greystone.png
WE ./textures/colorstone.png  
EA ./textures/bluestone.png	
S ./textures/barrel copy.png
F 255,0,0				
C 0,255,255

 11111111111111111111111111111111111
1000000000000000000000000000000000001
1000200000111111111111111110000000001
10002000001       1       10000000001
10002000001      101      10000200001
10002000001       1       10000200001     
1000000000111111111111111110000000001
10W0000000000000000000000000000000001
 11111111111111111111111111111111111

