R 360 240
NO ./textures/redbrick.png
SO ./textures/greystone.png
WE ./textures/colorstone.png
EA ./textures/bluestone.png

S ./textures/barrel.png
F 220,100,0


1111111111111111111111111111111111111
1000000000000000000000000000000000001
1000200000111111111111111110000000001
10000000001               10000000001
10000000001               10000200001
1000000000111111111111111110000000001
1000000000000000000000000000000000001
1111111111111111111111111111111111111